# IPA-to-SAMPA phoneme mappings.
.	.
ˈ	"
ˌ	%
ˀ	_?
(ã)	(a~)
(bʲ)	(b_j)
(ɕ)	(s\)
(dʲ)	(d_j)
(ʣ̪)	(dz_d)
(e̞ː)	(e_o:)
(ə)	(@)
(ɛ̃)	(E~)
(ɛː)	(E:)
(ɡʲ)	(g_j)
(iː)	(i:)
(ie̞)	(ie_o)
(lʲ)	(l_j)
(nʲ)	(n_j)
(œ)	(9)
(œː)	(9:)
(ɔ̃)	(O~)
(ɔː)	(O:)
(sʲ)	(s_j)
(uː)	(u:)
(ɯɤ̞)	(M7_o)
(ɯi)	(Mi)
(yː)	(y:)
(ʑ)	(z\)
(ʒ)	(Z)
‖	||
|	|
|̬	|\_v
|̃	|\~
|̬|̬	|\|\_v
|̃|̃	|\|\~
||ʰ	|\|\_h
|̃|̃ʰ	|\|\~_h
|ʰ	|\_h
|̃ʰ	|\~_h
a	a
a̟	a
a̠	a_-
ä	a_"
å	a_0
a̰	a_k
ã̰	a_k~
a̤	a_t
ă	a_X
ã	a~
ã̤	a~_t
a˞	a`
a˞ː	a`:
a˞ˤ	a`_?\
a̠ː	a_-:
a̰ː	a_k:
a̤ː	a_t:
aː	a:
ãː	a:~
ãː	a:~
ã̤ː	a~_t:
ãː	a~:
âː	a:_F
áː	a:_H
àː	a:_L
â	a_F
á	a_H
à	a_L
aːi	a:i
aːɪ	a:I
aːj	a:j
aːu	a:u
aːɯ	a:M
aːʊ	a:U
a̰ˑ	a_k:\
a̤ˑ	a_t:\
aˑ	a:\
æ	{
æ̰	{_k
æ̞̃	{_o~
æ̤	{_t
æ̃	{~
ae	ae
ae̞	ae_o
æ̤ː	{_t:
æː	{:
æ̃ː	{:~
æ̃ː	{~:
æːː	{::
æːi	{:i
æːj	{:j
æːu	{:u
æːʊ	{:U
æːw	{:w
æe	{e
æ̃i	{~i
æi	{i
æ̃ɪ̃	{~I~
æɪ	{I
æj	{j
æo	{o
æu	{u
æʉ	{}
æw	{w
æˤ	{_?\
ãẽ̞ˤ	a~e_o~_?\
ae̞ˤ	ae_o_?\
aə	a@
ãɛ̃	a~E~
aɛ	aE
aˠ	a_G
aʰ	a_h
a̰ʰ	a_k_h
a̰ḭ	a_ki_k
a̤i̤	a_ti_t
ãi	a~i
ãĩ	a~i~
ai	ai
aiː	ai:
a̰ɪ̰	a_kI_k
aɪ	aI
aɪ̃	aI~
ãɪː	a~I:
aɨ	a1
aʲ	a_j
ãʲ	a~_j
ãj	a~j
aj	aj
aʲː	a_j:
âi	ai_F
ái	ai_H
ài	ai_L
ãõ	a~o~
ao	ao
ao̞	ao_o
ãõ̞ˤ	a~o~_o_?\
ao̞ˤ	ao_o_?\
aɔ	aO
aɵ	a8
a̰ṵ	a_ku_k
a̤ṳ	a_tu_t
ãũ	a~u~
au	au
auː	au:
âu	au_F
áu	au_H
àu	au_L
a̰ɯ̰	a_kM_k
a̤ɯ̤	a_tM_t
aɯ	aM
aɯ̃	aM~
aɰ	aM\
aʊ	aU
aʊ̃	aU~
ãw	a~w
ãw̃	a~w~
aw	aw
ay	ay
aˀ	a_?
aˤ	a_?\
ãˤ	a~_?\
aˤː	a_?\:
ãˤː	a~_?\:
ɐ	6
ɐ̯	6_^
ɐ̹	6_O
ɐ̆	6_X
ɐ̃	6~
ɐː	6:
ɐ̃i	6~i
ɐi	6i
ɐɪ	6I
ɐ̃u	6~u
ɐu	6u
ɐʊ	6U
ɐˤ	6_?\
ɑ	A
ɑ̈	A_"
ɑ̞	A_o
ɑ̤	A_t
ɑ̆	A_X
ɑ̃	A~
ɑ˞	A`
ɑ̈ː	A_":
ɑ̰ː	A_k:
ɑ̤ː	A_t:
ɑː	A:
ɑ̃ː	A:~
ɑ̃ː	A~:
ɑːː	A::
ɑːi	A:i
ɑːɨ	A:1
ɑːu	A:u
ɑːw	A:w
ɑɒ	AQ
ɑe	Ae
ɑ̃ĩ	A~i~
ɑi	Ai
ɑĩ	Ai~
ɑɪ	AI
ɑj	Aj
ɑj̃	Aj~
ɑ̃õ	A~o~
ɑo	Ao
ɑ̃ɔ̃	A~O~
ɑu	Au
ɑũ	Au~
ɑʊ	AU
ɑw	Aw
ɑw̃	Aw~
ɒ	Q
ɒ̤	Q_t
ɒ̃	Q~
ɒː	Q:
ɒ̃ː	Q~:
ɒːi	Q:i
b	b
b͉	b_}
b̩	b=
b̊	b_0
b̥	b_0
b̪	b_d
b̰	b_k
b̤	b_t
b̤̥	b_t_0
b̃	b~
b˞	b`
b͈ː	b_"\:
b̊ː	b_0:
b̥ː	b_0:
bː	b:
bb	bb
bɡ	bg
bˠ	b_G
bʰ	b_h
bʱ	b_h\
b̤ʱ	b_t_h\
bʲ	b_j
bʲ	b'
bʲː	b_j:
bⁿ	b_n
br	br
bɾ	b4
b̤v̤	b_tv_t
bv	bv
bvʷ	bv_w
bʷ	b_w
b̃ʷ	b~_w
bʷː	b_w:
bʷˠ	b_w_G
b̤z̤	b_tz_t
bz	bz
bzʷ	bz_w
bˀ	b_?
bʼ	b_>
bˤ	b_?\
bˤː	b_?\:
bβ	bB
ʙ	B\
ɓ	b_<
ɓ̊	b_<_0
ɓ̥	b_<_0
ɓ̊ː	b_<_0:
ɓ̥ː	b_<_0:
ɓː	b_<:
ɓʲ	b_<_j
ɓʷ	b_<_w
c	c
ç	C
c̰	c_k
c̤	c_t
cː	c:
çː	C:
cːʰ	c:_h
cc	cc
cç	cC
c͡ç	cC
cçː	cC:
cçʰ	cC_h
cçʷ	cC_w
cçʼ	cC_>
cɕ	cs\
cɕʰ	cs\_h
cʰ	c_h
çʰ	C_h
cʲ	c_j
çʲ	C_j
cɲ	cJ
cʷ	c_w
çʷ	C_w
cʷʰ	c_w_h
cʼ	c_>
cʼː	c_>:
ɕ	s\
ɕː	s\:
ɕʰ	s\_h
ɕᶣ	s\_H
ɕʷ	s\_w
ɕʷʼ	s\_w_>
ɕʼ	s\_>
d	d
ð	D
d̠	d_-
d̠̰	d_-_k
d̩	d=
d̊	d_0
d̥	d_0
d̺	d_a
ð̺̪	D_a_d
d̪	d_d
d̪̚	d_d_}
d̪̊	d_d_0
d̪̥	d_d_0
d̪̺	d_d_a
d̪̰	d_d_k
d̪̤	d_d_t
d̰	d_k
d̞	d_o
ð̞	D_o
d̤	d_t
d̤̥	d_t_0
d̃	d~
d͈ː	d_"\:
d̊ː	d_0:
d̥ː	d_0:
d̺ː	d_a:
d̪ː	d_d:
dː	d:
ðː	D:
d̪ː	d:_d
dːz	d:z
dːʒ	d:Z
d̪ð	d_dD
dd	dd
ddz	ddz
ddʒ	ddZ
d̪ˠ	d_d_G
dˠ	d_G
d̻ʲ	d'
ðˠ	D_G
d̠ʰ	d_-_h
d̪ʰ	d_d_h
dʰ	d_h
d̺ʱ	d_a_h\
d̪ʱ	d_d_h\
d̪̤ʱ	d_d_t_h\
d̤ʱ	d_t_h\
d̠ʲ	d_-_j
d̊ʲ	d_0_j
d̥ʲ	d_0_j
d̪ʲ	d_d_j
dʲ	d_j
dʲ	d'
ðʲ	D_j
dʲʷ	d_j_w
dʝ	dj\
d̪l̪	d_dl_d
dlʷ	dl_w
d̪ɮ̪	d_dK\_d
d̤ɮ̤	d_tK\_t
dɮ	dK\
d̠ⁿ	d_-_n
d̪ⁿ	d_d_n
dⁿ	d_n
dr	dr
dɾ	d4
dᶣ	d_H
d̪ʷ	d_d_w
dʷ	d_w
d̪x	d_dx
dx	dx
d̊z̊	d_0z_0
d̥z̥	d_0z_0
d̺z̺	d_az_a
d̪z̪	d_dz_d
d̪z̪̤	d_dz_d_t
d̤z	d_tz
d̤z̤	d_tz_t
ʣ	dz
dz	dz
d͡z	dz
ʣ̪	dz_d
ʣ̤	dz_t
ʣ̃	dz~
d̺z̺ː	d_az_a:
ʣː	dz:
ʣˠ	dz_G
ʣʰ	ʣ_h
ʣʰ	dz_h
ʣʱ	ʣ_h\
d̊z̊ʲ	d_0z_0_j
d̥z̥ʲ	d_0z_0_j
d̪ᶻʲ	d_d_z_j
d̪z̪ʲ	d_dz_d_j
ʣʲ	dz_j
ʣʲ	dz'
ʣʷ	dz_w
ʣʼ	dz_>
dʐ	dz`
d̊ʑ̊	d_0z\_0
d̥ʑ̥	d_0z\_0
dʑ	dz\
ʥ	dz\
dʑʰ	dz\_h
dʑᶣ	dz\_H
ʥᶣ	dz\_H
dʑʷ	dz\_w
d̠̤ʒ̤	d_-_tZ_t
d̠ʒ	d_-Z
d̠ʒ̤	d_-Z_t
d̊ʒ̊	d_0Z_0
d̥ʒ̊	d_0Z_0
d̺ʒ̺	d_aZ_a
d̤ʒ̤	d_tZ_t
ʤ	dZ
dʒ	dZ
d͡ʒ	dZ
ʤ̤	dZ_t
d̠ʒː	d_-Z:
ʤː	dZ:
d̠ʒˠ	d_-Z_G
d̠ʒʰ	d_-Z_h
ʤʰ	dZ_h
dʒʰ	dZ_h
d̤ʒ̤ʱ	d_tZ_t_h\
ʤʱ	dZ_h\
d̠ʒʲ	d_-Z_j
ʤʲ	dZ_j
d̠ʒɾ	d_-Z4
d̠ʒʷ	d_-Z_w
d̺ʒ̺ʷ	d_aZ_a_w
ʤʷ	dZ_w
d̠ʒxʼ	d_-Zx_>
d̠ʒʼ	d_-Z_>
dˀ	d_?
dʼ	d_>
ðʼ	D_>
dʼkxʼ	d_>kx_>
d̪ʼkxʼ	d_d_>kx_>
dˤ	d_?\
ðˤ	D_?\
d̪ˤ	d_d_?\
dˤː	d_?\:
ɖ	d`
ɖ̰	d`_k
ɖ̤	d`_t
ɖː	d`:
ɖʰ	d`_h
ɖʱ	d`_h\
ɖ̤ʱ	d`_t_h\
ɖʲ	d`_j
ɖⁿ	d`_n
ɖr	d`r
ɖr̠͓	d`r_-_x
ɖr͓	d`r_x
ɖɽ	d`r`
ɖ̥ʐ̥	d`_0s`_0
ɖ̊ʐ̊	d`_0z`_0
ɖʐ	d`z`
ɖʐʷ	d`z`_w
ɗ	d_<
ɗ̠	d_<_-
ɗ̊	d_<_0
ɗ̥	d_<_0
ɗ̪	d_<_d
ɗː	d_<:
ɗʰ	d_<_h
ɗʲ	d_<_j
ɗʷ	d_<_w
ɗʒ	d_<Z
ᶑ	d`_<
ᶑː	d`_<:
ᶑʼ	d`_<_>
ᶑʼː	d`_<_>:
e	e
e̠	e_-
ë	e_"
e̯	e_^
e̊	e_0
e̥	e_0
ḛ	e_k
ḛ̃	e_k~
e̞	e_o
e̞̠	e_o_-
ë̞	e_o_"
e̞̊	e_o_0
e̞̥	e_o_0
e̞̰	e_o_k
ẽ̞	e_o~
e̤	e_t
ĕ	e_X
ẽ	e~
e˞	e`
ëː	e_":
e̊ː	e_0:
e̥ː	e_0:
ḛː	e_k:
e̞ː	e_o:
ẽ̞ː	e_o~:
e̤ː	e_t:
eː	e:
ẽː	e:~
ẽː	e:~
ẽː	e~:
eːː	e::
eːə	e:@
eːi	e:i
eːj	e:j
ḛˑ	e_k:\
e̤ˑ	e_t:\
eˑ	e:\
êː	e:_F
éː	e:_H
èː	e:_L
ê	e_F
é	e_H
è	e_L
e̞a	e_oa
ea	ea
ea̤	ea_t
eɑ	eA
e̞ə	e_o@
eə	e@
eɛ	eE
eɘ	e@\
eˠ	e_G
eʰ	e_h
e̞i	e_oi
ẽ̞ĩ	e~_oi~
ẽĩ	e~i~
ei	ei
ḛɪ̰	e_kI_k
ẽɪ̃	e~I~
eɪ	eI
eɪ̃	eI~
eʲ	e_j
ẽj	e~j
ej	ej
e̞o̞	e_oo_o
eo	eo
eɔ	eO
e̞u	e_ou
ẽ̞ũ	e~_ou~
eu	eu
eũ	eu~
eʊ	eU
ew	ew
ew̃	ew~
eˀ	e_?
eˤ	e_?\
e̞ˤ	e_o_?\
ə	@
ə̥	@_0
ə̰	@_k
ə̰̃	@_k~
ə̞̆	@_o_X
ə̤	@_t
ə̆	@_X
ə̃	@~
ɚ	@`
ə˞	@`
ə˞ː	@`:
əː	@:
əː̃	@:~
ə̤̃ː	@~_t:
ə̃ː	@~:
əːi	@:i
əˑ	@:\
əɒ	@Q
ə̃ĩ	@~i~
əi	@i
əĩ	@i~
əɨ	@1
əj	@j
ə̃j	@j~
əo	@o
ə̃ũ	@~u~
əu	@u
əũ	@u~
ə̰ɯ̰	@_kM_k
əɯ	@M
əɯ̃	@M~
əʊ	@U
əw	@w
ə̃w	@w~
əy	@y
əˤ	@_?\
ɛ	E
ɛ̠	E_-
ɛ̰	E_k
ɛ̞	E_o
ɛ̤	E_t
ɛ̆	E_X
ɛ̃	E~
ɛ˞	E`
ɛ̠ː	E_-:
ɛ̰ː	E_k:
ɛ̞ː	E_o:
ɛ̤ː	E_t:
ɛː	E:
ɛ̃ː	E:~
ɛ̤̃ː	E~_t:
ɛ̃ː	E~:
ɛ̃ːi	E~:i
ɛ̰ˑ	E_k:\
ɛ̤ˑ	E_t:\
ɛˑ	E:\
ɛa	Ea
ɛæː	E{:
ɛɐ	E6
ɛe	Ee
ɛə	E@
ɛ̃ə	E~@
ɛˠ	E_G
ɛ̤i̤	E_ti_t
ɛi	Ei
ɛɪ	EI
ɛɨ	E1
ɛj	Ej
ɛo	Eo
ɛo̞	Eo_o
ɛ̃ɔ̃	E~O~
ɛ̃ũ	E~u~
ɛu	Eu
ɛʉ	E}
ɛɯ	EM
ɛɰ	EM\
ɛʊ	EU
ɛw	Ew
ɛˤ	E_?\
ɘ	@\
ɘ̠	@\_-
ɘ̆	@\_X
ɘ̃	@\~
ɘ˞	@\`
ɘː	@\:
ɘ̃ː	@\~:
ɘi	@\i
ɘy	@\y
ɜ	3
ɜ̃	3~
ɝ	3`
ɜː	3:
ɜi	3i
ɜɪ	3I
ɜj	3j
ɞ	3\
ɞ̠	3\_-
ɞ̰	3\_k
ɞ̠ː	3\_-:
ɞː	3\:
ɞ̃ː	3\~:
ɞe	3\e
ɞʏ	3\Y
ɤ	7
ɤ̞	7_o
ɤ̞̃	7_o~
ɤ̤	7_t
ɤ̞̆	7_X_o
ɤ̃	7~
ɤ̞ː	7_o:
ɤ̤ː	7_t:
ɤː	7:
ɤ̃ː	7~:
ɤːː	7::
ɤˑ	7:\
ɤa	7a
ɤa̤	7a_t
ɤɑ	7A
ɤe	7e
ɤ̤i̤	7_ti_t
ɤi	7i
ɤj	7j
ɤo	7o
ɤu	7u
f	f
f̩	f=
f̰	f_k
f͈ː	f_"\:
fː	f:
fːː	f::
ff	ff
fˠ	f_G
fʰ	f_h
fʲ	f_j
fʲ	f'
fʲː	f_j:
fɾ	f4
fʃ	fS
fʷ	f_w
fʷː	f_w:
fʼ	f_>
gg	gg
gʲ	g'
gʲ	g_j
ɡ	g
ɡ̩	g=
ɡ̊	g_0
ɡ̰	g_k
ɡ̤	g_t
ɡ̤̥	g_t_0
ɡ̃	g~
ɡ˞	g`
ɡ͈ː	g_"\:
ɡ̊ː	g_0:
ɡː	g:
ɡːʷ	g:_w
ɡb	gb
ɡb̩	gb=
ɡbː	gb:
ɡbʲ	gb_j
ɡbr	gbr
ɡbɾ	gb4
ɡbʷ	gb_w
ɡbˤ	gb_?\
ɡɓ	gb_<
ɡɣ	gG
gʰ	g_h
ɡʰ	g_h
ɡʱ	g_h\
ɡ̤ʱ	g_t_h\
ɡʲ	g_j
ɡʲː	g_j:
ɡʲʷ	g_j_w
ɡˡ	g_l
ɡm	gm
ɡⁿ	g_n
ɡɾ	g4
ɡᶣ	g_H
ɡ̩ʷ	g=_w
ɡ̤ʷ	g_t_w
ɡʷ	g_w
ɡʼ	g_>
ɡʼkxʼ	g_>kx_>
ɡ̤ǀ	g_t|\
ɡ̤ǀ͓	g_t|\_x
ɡǀ	g|\
ɡǀ͓	g|\_x
ɡǀʰ	g|\_h
ɡǀkxʼ	g|\kx_>
ɡǀqʰ	g|\q_h
ɡ̰ǀ͓x	g_k|\_xx
ɡǀ͓x	g|\_xx
ɡǀx	g|\x
ɡǀxʼ	g|\x_>
ɡ̤ǁ	g_t|\|\
ɡǁ	g|\|\
ɡǁkxʼ	g|\|\kx_>
ɡǁqʰ	g|\|\q_h
ɡǁx	g|\|\x
ɡǁxʼ	g|\|\x_>
ɡ̤ǂ	g_t=\
ɡǂ	g=\
ɡǂkxʼ	g=\kx_>
ɡ̤ǂ͓ˡ	g_t=\_x_l
ɡǂ͓ˡ	g=\_x_l
ɡ̰ǂ͓ˡx	g_k=\_x_lx
ɡǂ͓ˡx	g=\_x_lx
ɡǂqʰ	g=\q_h
ɡ̰ǂx	g_k=\x
ɡǂx	g=\x
ɡ̤ǃ	g_t!\
ɡǃ	g!\
ɡǃʰ	g!\_h
ɡǃkxʼ	g!\kx_>
ɡǃqʰ	g!\q_h
ɡ̰ǃx	g_k!\x
ɡǃx	g!\x
ɡǃxʼ	g!\x_>
ɡǃǃ	g!\!\
ɡǃǃʰ	g!\!\_h
ɡǃǃx	g!\!\x
ɡǃǃxʼ	g!\!\x_>
ɡʘ	gO\
ɡʘkxʼ	gO\kx_>
ɡʘqʰ	gO\q_h
ɡʘx	gO\x
ɢ	G\
ɢ̊	G\_0
ɢ̥	G\_0
ɢː	G\:
ɢʰ	G\_h
ɢʁ	G\R
ɢʷ	G\_w
ɢʷˤ	G\_w_?\
ɢˤ	G\_?\
ɢǀ	G\|\
ɢǁ	G\|\|\
ɢǂ	G\=\
ɢǃ	G\!\
ɢʘ	G\O\
ɠ	g_<
ɠ̊	g_<_0
ɠː	g_<:
ɠɓ	g_<b_<
ʛ̊	G_<_0
ʛ	G\_<
ɣ	G
ɣ̩	G=
ɣ̊	G_0
ɣ̰	G_k
ɣ̤	G_t
ɣ͈ː	G_"\:
ɣː	G:
ɣʲ	G_j
ɣʲ	G'
ɣv	Gv
ɣʷ	G_w
ɣˀ	G_?
h	h
h̃	h~
ħ	X\
hː	h:
ħ͈ː	X\_"\:
ħː	X\:
hːː	h::
ʰb	_hb
ʰc	_hc
ʰd	_hd
ħħ	X\X\
ʰj	_hj
hʲ	h_j
hʲ	h'
ħ̃ʲ	X\~_j
hʲʷ	h_j_w
ʰɟ	_hJ\
ʰk	_hk
ʰkː	_hk:
ʰkʲ	_hk_j
ʰkʷ	_hk_w
ʰl	_hl
ʰl̊	_hl_0
ʰl̥	_hl_0
ʰm	_hm
ʰn	_hn
ʰn̪	_hn_d
ʰŋ	_hN
ʰp	_hp
ʰpː	_hp:
ʰpʲ	_hp_j
ʰɾ	_h4
ʰs̪	_hs_d
ʰʃ	_hS
ʰt	_ht
ʰtː	_ht:
ʰʨ	_hts\
ʰtʲ	_ht_j
ʰʦ	_hts
ʰʦː	_hts:
ʰʦʲ	_hts_j
ʰt̠ʃ	_ht_-S
ʰʧ	_htS
ʰʧː	_htS:
ʰʈ	_ht`
hᶣ	h_H
hv	hv
ʰw	_hw
hʷ	h_w
ħʷ	X_w
ʰʷɕʰ	_h_ws\_h
ʰʷk	_h_wk
ʰʷs	_h_ws
ʰʷsʰ	_h_ws_h
ʰʷʂʰ	_h_ws`_h
ʰʷt	_h_wt
ʰʷʨ	_h_wts\
ʰʷʦ	_h_wts
ʰʷʈ	_h_wt`
hʼ	h_>
ʜ	H\
ʜʷ	H\_w
ɦ	h\
ɦ̤	h\_t
ʱb	_h\b
ʱd	_h\d
ʱʣ	_h\dz
ʱdʑ	_h\dz\
ʱɖ	_h\d`
ʱɡ	_h\g
ʱj	_h\j
ʱɟ	_h\J\
ʱl	_h\l
ʱm	_h\m
ʱn	_h\n
ʱɲ	_h\J
ʱŋ	_h\N
ɦʷ	h\_w
ʱz	_h\z
ʱʐ	_h\z`
ɧ	x\
i	i
i̠	i_-
ï	i_"
i̯	i_^
i̊	i_0
i̥	i_0
ḭ	i_k
ḭ̃	i_k~
i̞	i_o
ĩ̞	i_o~
i̤	i_t
ĭ	i_X
i̽	i_x
i͓	i_x
ĩ	i~
i˞	i`
i˞ˤ	i`_?\
i˞ˤː	i`_?\:
ḭː	i_k:
i̞ː	i_o:
i̤ː	i_t:
iː	i:
ĩː	i:~
ĩː	I:~
ĩː	i~:
ĩ̤ː	i~_t:
iːː	i::
iːa	i:a
iːe	i:e
iːə	i:@
iːɛ	i:E
iːu	i:u
iːw	i:w
ḭˑ	i_k:\
i̤ˑ	i_t:\
iˑ	i:\
îː	i:_F
íː	i:_H
ìː	i:_L
î	i_F
í	i_H
ì	i_L
i̤a	i_ta
i̤a̤	i_ta_t
ĩã	i~a~
ia	ia
iã	ia~
iaː	ia:
iæ	i{
iæ̃	i{~
iau	iau
i̤ɐ	i_t6
iɐ	i6
iɑ	iA
iɑu	iAu
ĩẽ	i~e~
ĩẽ̞	i~e~_o
ie	ie
ie̞	ie_o
iẽ	ie~
ieː	ie:
i̤ə̤	i_t@_t
iə	i@
ĩə	i~@
i̤ɛ̤	i_tE_t
iɛ	iE
iɛ̠	iE_-
iɛ̃	iE~
iɛː	iE:
iɛi	iEi
iɘ	i@\
iɜ	i3
iˠ	i_G
iʰ	i_h
ii	ii
iɪ	iI
ij	ij
ĩõ	i~o~
iø	i2
io	io
io̞	io_o
iou	iou
iɔ	iO
iɔː	iO:
i̤ṳ	i_tu_t
iu	iu
iũo	iu~o
iuo	iuo
iʊ	iU
iʌ	iV
iw	iw
iˀ	i_?
iˤ	i_?\
iˤː	i_?\:
iˤæ	i_?\{
ɪ	I
ɪ̰	I_k
ɪ̞	I_o
ɪ̤	I_t
ɪ̆	I_X
ɪ̈	I\
ɪ̃	I~
ɪː	I:
ɪ̈ː	I\:
ɪ̃ː	I~:
ɪ̃ː	I:~
ɪa	Ia
ɪã	Ia~
ɪe̞	Ie_o
ɪə	I@
ɪ̃ə̃	I~@~
ɪ̃ɛ	I~E
ɪɛ	IE
ɪ̃ɛː	I~E:
ɪɛː	IE:
ɪˠ	I_G
ɪi	Ii
ɪɔ	IO
ɪu	Iu
ɪu̞	Iu_o
ɪʊ	IU
ɪʌ	IV
ɪw	Iw
ɪˤ	I_?\
ɨ	1
ɨ̠	1_-
ɨ̰	1_k
ɨ̞	1_o
ɨ̞̰	1_o_k
ɨ̤	1_t
ɨ̆	1_X
ɨ̃	1~
ɨ˞	1`
ɨ̞ː	1_o:
ɨ̤ː	1_t:
ɨː	1:
ɨ̞̃ː	1~_o:
ɨ̃ː	1~:
ɨːa	1:a
ɨˑ	1:\
ɨa	1a
ɨa̠	1a_-
ɨ̤ɐ	1_t6
ɨɐ	16
ɨə	1@
ɨɛ	1E
ɨi	1i
ɨj	1j
ɨu	1u
ɨw	1w
j	j
j̊	j̊
j̊	j_0
j̰	j_k
j̃	j~
jː	j:
jːː	j::
ja	ja
jaː	ja:
jãː	ja~:
jæ	j{
jæi	j{i
jai	jai
jau	jau
je	je
jẽ	je~
jei	jei
jeu	jeu
jɛ	jE
jɛ̃	jE~
jɛː	jE:
jɛi	jEi
jʰ	j_h
ji	ji
jʲ	j'
jj	jj
jo	jo
joː	jo:
joi	joi
jɔ	jO
ju	ju
juː	ju:
juaː	jua:
jui	jui
j̊ʷ	j_0_w
jʷ	j_w
jy	jy
jʔ	j?
jˀ	j_?
jʼ	j_>
jˤ	j_?\
ʝ	j\
ʝ̞	j\_o
ʝː	j\:
ɟ	J\
ɟ̰	J\_k
ɟ̤	J\_t
ɟː	J\:
ɟʰ	J\_h
ɟʱ	j\_h\
ɟʲ	J\_j
ɟ̊ʝ̊	J\_0j\_0
ɟ̥ʝ̥	J\_0j\_0
ɟ̤ʝ	J\_tj\
ɟʝ	J\j\
ɟ͡ʝ	J\j\
ɟʝʷ	J\j\_w
ɟɟ	J\J\
ɟʷ	J\_w
ɟʑ	J\z\
ʄ	J\_<
ʄ̊	J\_<_0
ʄ̥	J\_<_0
k̚	k_}
k	k
k͈	k_"\
k͈	k*
k̰	k_k
k̃	k~
k˞	k`
k͈ː	k_"\:
kː	k:
kːː	k::
kːʰ	k:_h
kːʷ	k:_w
kːʷʰ	k:_w_h
kːʼ	k:_>
kɡ	kg
kʰ	k_h
kʰ˞	k_h`
kʰː	k_h:
kʰʲ	k_h_j
kʰʷ	k_h_w
kʰʷʲ	k_h_w_j
kɦ	kh\
kʲ	k_j
kʲ	k'
kʲː	k_j:
kʲː	k':
kʲʰ	k_j_h
kʲʰ	k'_h
kʲʷ	k_j_w
kʲʷ	k'_w
kʲʼ	k_j_>
kk	kk
kl	kl
kʟ̊ʼ	kL\_0_>
kʟ̥ʼ	kL\_0_>
kɬʼ	kK_>
km	km
kŋ	kN
kp	kp
kpː	kp:
kpʰ	kp_h
kpʲ	kp_j
kpr	kpr
kpɾ	kp4
kpʷ	kp_w
kpˤ	kp_?\
kɾ	k4
kᶣ	k_H
k͈ʷ	k_"\_w
k̰ʷ	k_k_w
kʷ	k_w
k̃ʷ	k~_w
kʷː	k_w:
kʷʰ	k_w_h
kʷʱ	k_w_h\
kʷʲ	k_w_j
kʷɾ	k_w4
kʷˀ	k_w_?
kʷʼ	k_w_>
kʷʼʲ	k_w_>_j
kx	kx
kxː	kx:
kxːʰ	kx:_h
kxːʼ	kx:_>
kxʰ	kx_h
kxʷʰ	kx_w_h
kxʼ	kx_>
kxʼː	kx_>:
kˀ	k_?
kʼ	k_>
kʼː	k_>:
kʼːʷ	k_>:_w
kʼʲ	k_>_j
kʼʲ	k_>'
kʼʷ	k_>_w
kˤ	k_?\
kǀ	k|\
kǀ̪	k|\_d
kǀ͓	k|\_x
kǀ͓ˠʰ	k|\_G_h
kǀʰ	k|\_h
kǀ͓ʰ	k|\_x_h
kǀʰʷ	k|\_h_w
kǀʰʼ	k|\_h_>
kǀʷ	k|\_w
kǀ͓x	k|\_xx
kǀx	k|\x
kǀxʼ	k|\x_>
kǀʼ	k|\_>
kǁ	k|\|\
kǁ͓	k|\|\_x
kǁʰ	k|\|\_h
kǁ͓ʰ	kǁ_x_h
kǁx	k|\|\x
kǁ͓xʰ	k|\|\_xx_h
kǁxʼ	k|\|\x_>
kǁʼ	k|\|\_>
kǁʼʰ	k|\|\_>_h
kǂ	k=\
kǂʰ	k=\_h
kǂ͓ˡ	k=\_x_l
kǂ͓ˡʰ	k=\_x_l_h
kǂ͓ˡx	k=\_x_lx
kǂx	k=\x
kǂxʼ	k=\x_>
kǂʼ	k=\_>
kǃ	k!\
kǃ̠	k!\_-
kǃ̪	k!\_d
kǃ͓	k!\_x
kǃ̠ʰ	k!\_-_h
kǃʰ	k!\_h
kǃʰʼ	k!\_h_>
kǃx	k!\x
kǃ̠xʰ	k!\_-x_h
kǃxʰ	k!\x_h
kǃxʼ	k!\x_>
kǃʼ	k!\_>
kǃǃ	k!\!\
kǃǃʰ	k!\!\_h
kǃǃʰʼ	k!\!\_h_>
kǃǃx	k!\!\x
kǃǃxʼ	k!\!\x_>
kǃǃʼ	k!\!\_>
kʘ	kO\
kʘʰ	kO\_h
kʘx	kO\x
kʘxʼ	kO\x_>
kʘʼ	kO\_>
l	l
l̠	l_-
l̠̤	l_-_t
l̩	l=
l̊	l_0
l̥	l_0
l̺	l_a
l̪	l_d
l̪̊	l_d_0
l̪̥	l_d_0
l̪̰	l_d_k
l̪̤	l_d_t
l̰	l_k
l̤	l_t
l̃	l~
l̠˞	l_-`
l͈ː	l_"\:
l̊ː	l_0:
l̥ː	l_0:
l̪ː	l_d:
lː	l:
lːː	l::
ld	ld
l̊ˠ	l_0_G
l̥ˠ	l_0_G
l̪ˠ	l_d_G
lˠ	l_G
lʰ	l_h
l̪ʱ	l_d_h\
lʱ	l_h\
l̠ʲ	l_-_j
l̊ʲ	l_0_j
l̥ʲ	l_0_j
l̪ʲ	l_d_j
lʲ	l_j
lʲ	l'
l̊ʲː	l_0_j:
l̥ʲː	l_0_j:
lʲː	l_j:
lʲːː	l_j::
lʲʰ	l_j_h
lʲʷ	l_j_w
ll	ll
lᶣ	l_H
l̪ʷ	l_d_w
lʷ	l_w
lʔ	l?
lˀ	l_?
lʼ	l_>
lʼː	l_>:
lˤ	l_?\
lˤː	l_?\:
ʟ	L\
ʟ͓̊	L\_0_x
ɫ	5
ɫ̊	5_0
ɫ̥	5_0
ɫ̺	5_a
ɫ̪	5_d
ɫː	5:
ɬ	K
ɬ̺̪	K_a_d
ɬ̪	K_d
ɬ̪ː	K_d:
ɬː	K:
ɬˠ	K_G
ɬ̪ʲ	K_d_j
ɬʲ	K_j
ɬ̪ʲʼ	K_d_j_>
ɬʲʼ	K_j_>
ɬ̪ʷ	K_d_w
ɬʷ	K_w
ɬ̪ʷː	K_d_w:
ɬʼ	K_>
ɬ̪ʼ	K_d_>
ɭ	l`
ɭ̊	l`_0
ɭ̥	l`_0
ɭ̤	l`_t
ɭ͓	l`_x
ɭː	l`:
ɭʷ	l`_w
ɮ	K\
ɮ̺	K\_a
ɮ̪	K\_d
ɮ̤	K\_t
ɮ̪ʲ	K\_d_j
ɮʲ	K\_j
ɮʲ	K\'
ɮʼ	K\_>
ʎ	L
ʎ̊	L_0
ʎː	L:
ʎʰ	L_h
ʎʎ	LL
ʎʼ	L_>
m	m
m̩	m=
m̩	m_=
m̊	m_0
m̥	m_0
m̪	m_d
m̰	m_k
m̤	m_t
m̩	m=
m͈ː	m_"\:
m̊ː	m_0:
m̥ː	m_0:
mː	m:
mːː	m::
m̤b̤	m_tb_t
mb	mb
mbˠ	mb_G
mbʲ	mb_j
mbɾ	mb4
m̤b̤v̤	m_tb_tv_t
mbv	mbv
mbʷ	mb_w
mbz	mbz
mɓ	mb_<
mˠ	m_G
m̊ʰ	m_0_h
m̥ʰ	m_0_h
mʰ	m_h
m̤ʰ	m_t_h
mʱ	m_h\
m̊ʲ	m_0_j
m̥ʲ	m_0_j
mʲ	m_j
mʲ	m'
m̊ʲː	m_0_j:
m̥ʲː	m_0_j:
mʲː	m_j:
mm	mm
m̊p	m_0p
mp	mp
mpf	mpf
mpfʼ	mpf_>
m̤pʰ	m_tp_h
mpʰ	mp_h
mpʲ	mp_j
mpɾ	mp4
mpʷ	mp_w
mpʼ	mp_>
mɾ	m4
mv	mv
mʷ	m_w
m̃ʷ	m~_w
mw	mw
mʷː	m_w:
mʷˠ	m_w_G
mʷˠː	m_w_G:
mˀ	m_?
mʼ	m_>
mˤ	m_?\
mˤː	m_?\:
ɱ	F
ɱ̊f	F_0f
ɱ̥f	F_0f
ɱ̤f	F_tf
ɱf	Ff
ɱfʲ	Ff_j
ɱfɾ	Ff4
ɱfʷ	Ff_w
ɱv	Fv
ɱvʲ	Fv_j
ɱvɾ	Fv4
n	n
n̠	n_-
n̠̊	n_-_0
n̠̥	n_-_0
n̠̤	n_-_t
n̩	n=
n̊	n_0
n̥	n_0
n̪̊	n_0_d
n̥̪	n_0_d
n̺	n_a
n̺̪	n_a_d
n̪	n_d
n̪̩	n_d=
n̪̊	n_d_0
n̪̥	n_d_0
n̪̰	n_d_k
n̪̤	n_d_t
n̰	n_k
n̤	n_t
n̩	n=
n͈ː	n_"\:
n̊ː	n_0:
n̥ː	n_0:
n̪ː	n_d:
nː	n:
nːː	n::
n̻ʲ	n'
ⁿb	_nb
ⁿc	_nc
ⁿcʰ	_nc_h
ⁿd	_nd
ⁿd̪	_nd_d
n̠d̠	n_-d_-
n̪d̪	n_dd_d
n̤d̤	n_td_t
nd	nd
nð	nD
nd̪	nd_d
n̪d̪ʲ	n_dd_d_j
ndʲ	nd_j
ndl	ndl
n̤d̤ɮ̤	n_td_tK\_t
ndr	ndr
ndɾ	nd4
n̪d̪ʷ	n_dd_d_w
ndʷ	nd_w
ⁿd̪z̪	_nd_dz_d
ⁿʣ	_ndz
n̪d̪z̪	n_dd_dz_d
n̤d̤z̤	n_td_tz_t
nʣ	ndz
nʣʲ	ndz_j
nʣʷ	ndz_w
ⁿdʑ	_ndz\
ndʑ	ndz\
nʥ	ndz\
ⁿʤ	_ndZ
n̠̩d̠ʒ	n_-=d_-Z
n̠̤d̠̤ʒ	n_-_td_-_tZ
n̠d̠ʒ	n_-d_-Z
n̩ʤ	n=dZ
nʤ	ndZ
n̠d̠ʒʷ	n_-d_-Z_w
ⁿɖ	_nd`
ⁿɖɽ	_nd`r`
ⁿɖʐ	_nd`s`
nɗ	nd_<
ⁿɡ	_ng
n̤ɡ̤	n_tg_t
nɡ	ng
nɡɾ	ng4
ⁿɢ	_nG\
n̊ˠ	n_0_G
n̥ˠ	n_0_G
n̪ˠ	n_d_G
nˠ	n_G
n̪ʰ	n_d_h
nʰ	n_h
n̤ʰ	n_t_h
nh	nh
n̪ʱ	n_d_h\
nʱ	n_h\
n̠ʲ	n_-_j
n̊ʲ	n_0_j
n̥ʲ	n_0_j
n̪ʲ	n_d_j
nʲ	n_j
nʲ	n'
n̊ʲː	n_0_j:
n̥ʲː	n_0_j:
nʲː	n_j:
nʲːː	n_j::
nʲʷ	n_j_w
ⁿɟ	_nJ\
nɟ	nJ\
ⁿk	_nk
ⁿkʰ	_nk_h
ⁿkʲ	_nk_j
ⁿkʲʰ	_nk_j_h
nl	nl
nɬ	nK
nɮ	nK\
nn	nn
ⁿp	_np
ⁿpʰ	_np_h
ⁿpʲʰ	_np_j_h
ⁿq	_nq
ⁿqʰ	_nq_h
ⁿqʷ	_nq_w
ⁿqʷʰ	_nq_w_h
nr	nr
nɾ	n4
n̪s̪	n_ds_d
n̤s	n_ts
ns	ns
ⁿsʰ	_ns_h
nsɾ	ns4
nsʷ	ns_w
n̠ʃ	n_-S
n̊ʃ	n_0S
n̥ʃ	n_0S
nʃ	nS
n̠ʃʷ	n_-S_w
ⁿt	_nt
n̠t̠	n_-t_-
n̪t̪	n_dt_d
nt	nt
ⁿʨ	_nts\
ⁿʨʰ	_nts\_h
ⁿtʰ	_nt_h
n̪t̪ʰ	n_dt_d_h
n̤tʰ	n_tt_h
ntʰ	nt_h
ⁿtʲ	_nt_j
ⁿtʲʰ	_nt_j_h
ntlʼ	ntl_>
ntɾ	nt4
ⁿʦ	_nts
n̪t̪s̪	n_dt_ds_d
nʦ	nts
ⁿt̪s̪ʰ	_nt_ds_d_h
ⁿʦʰ	_nts_h
n̪t̪s̪ʰ	n_dt_ds_d_h
nʦʼ	nts_>
ⁿʧ	_nʧ
n̠̊t̠ʃ	n_-_0t_-S
n̠̥t̠ʃ	n_-_0t_-S
n̠t̠ʃ	n_-t_-S
n̥ʧ	n_0tS
nʧ	ntS
ⁿʧʰ	_ntS_h
n̠t̠ʃʰ	n_-t_-S_h
n̠t̠ʃɾ	n_-t_-S4
n̠t̠ʃʷ	n_-t_-S_w
nʧʷ	ntS_w
n̠t̠ʃʼ	n_-t_-S_>
nʧʼ	ntS_>
ntʷ	nt_w
ntʼ	nt_>
ⁿʈʰ	_nt`_h
ⁿʈɽʰ	_nt`r`_h
ⁿʈʂ	_nt`s`
ⁿʈʂʰ	_nt`s`_h
n̪ʷ	n_d_w
n̤ʷ	n_t_w
nʷ	n_w
ⁿxʰ	_nx_h
n̪z̪	n_dz_d
nz	nz
nzɾ	nz4
nzʷ	nz_w
n̠ʒ	n_-Z
nˀ	n_?
nʼ	n_>
nˤ	n_?\
nˤː	n_?\:
nθ	nT
ɴ	N\
ɴː	N\:
ɴɢ	N\G\
ɴɢǀqʰ	N\G\|\q_h
ɴɢǁqʰ	N\G\|\|\q_h
ɴɢǃqʰ	N\G\!\q_h
ɴq	N\q
ɴqʰ	N\q_h
ɲ	J
ɲ̩	J=
ɲ̊	J_0
ɲ̰	J_k
ɲ̤	J_t
ɲː	J:
ɲc	Jc
ɲcɕ	Jcs\
ɲ̤cʰ	J_tc_h
ɲcʲ	Jc_j
ɲcʼ	Jc_>
ɲʰ	J_h
ɲ̤ʰ	J_t_h
ɲj	Jj
ɲ̤ɟ̤	J_tJ\_t
ɲɟ	JJ\
ɲɟʝ	JJ\j\
ɲɟʑ	JJ\z\
ɲʄ	JJ\_<
ɲɲ	JJ
ɲᶣ	J_H
ɲʷ	J_w
ɲʒ	JZ
ɲʼ	J_>
ɳ	n`
ɳ̊	n`_0
ɳ̥	n`_0
ɳ̤	n`_t
ɳɖ	n`d`
ɳɖr	n`d`r
ɳɖɽ	n`d`r`
ɳɖʐ	n`d`s`
ɳʰ	n`_h
ɳʱ	n`_h\
ɳʲ	n`_j
ɳʈ	n`t`
ɳʈr̥	n`t`r_0
ɳʈʂ	n`t`s`
ɳʈʂʰ	n`t`s`_h
ŋ	N
ŋ̩	N=
ŋ̩	N_=
ŋ̊	N_0
ŋ̰	N_k
ŋ̞	N_o
ŋ̤	N_t
ŋ̩	N=
ŋː	N:
ŋˑ	N:\
ŋb	Nb
ŋ̤ɡ̤	N_tg_t
ŋɡ	Ng
ŋɡʲ	Ng_j
ŋɡmb	Ngmb
ŋɡʷ	Ng_w
ŋ̤ɡǃ	N_tg!\
ŋɣ	NG
ŋɣʲ	NG_j
ŋɣᶣ	NG_H
ŋɣʷ	NG_w
ŋʰ	N_h
ŋ̤ʰ	N_t_h
ŋh	Nh
ŋhʲ	Nh_j
ŋhᶣ	Nh_H
ŋhʷ	Nh_w
ŋʱ	N_h\
ŋ̊ʲ	N_0_j
ŋʲ	N_j
ŋʲ	N'
ŋʲː	N_j:
ŋʲʷ	N_j_w
ŋk	Nk
ŋ̤kʰ	N_tk_h
ŋkʰ	Nk_h
ŋkʲ	Nk_j
ŋkɾ	Nk4
ŋkʷ	Nk_w
ŋkx	Nkx
ŋkʼ	Nk_>
ŋ̊m̊	N_0m_0
ŋm	Nm
ŋmɡb	Nmgb
ŋmʲ	Nm_j
ŋmkp	Nmkp
ŋmkpɾ	Nmkp4
ŋmˤ	Nm_?\
ŋɾ	N4
ŋ̩ʷ	N=_w
ŋ̊ʷ	N_0_w
ŋʷ	N_w
ŋʷː	N_w:
ŋˀ	N_?
ŋˤ	N_?\
ŋ̊ǀ	N_0|\
ŋ̤ǀ	N_t|\
ŋ̤ǀ͓	N_t|\_x
ŋǀ	N|\
ŋǀ͓	N|\_x
ŋ̊ǀ͓ʰ	N_0|\_x_h
ŋǀʰ	N|\_h
ŋ̊ǀ͓xˀ	N_0|\_xx_?
ŋ̊ǀ͓ˀ	N_0|\_x_?
ŋ̊ǁ	N_0|\|\
ŋ̤ǁ	N_t|\|\
ŋǁ	N|\|\
ŋǁ͓	N|\|\_x
ŋ̊ǁ͓ʰ	N_0|\|\_x_h
ŋ̊ǁ͓ˀ	N_0|\|\_x_?
ŋǁʼ	N|\|\_>
ŋ̊ǂ	N_0=\
ŋ̤ǂ	N_t=\
ŋǂ	N=\
ŋ̊ǂʰ	N_0=\_h
ŋ̤ǂ͓ˡ	N_t=\_x_l
ŋǂ͓ˡ	N=\_x_l
ŋ̊ǂ͓ˡʰ	N_0=\_x_l_h
ŋ̊ǂ͓ˡxˀ	N_0=\_x_lx_?
ŋ̊ǂ͓ˡˀ	N_0=\_x_l_?
ŋ̊ǂxˀ	N_0=\x_?
ŋ̊ǂˀ	N_0=\_?
ŋ̊ǃ	N_0!\
ŋ̤ǃ	N_t!\
ŋǃ	N!\
ŋǃ̠	N!\_-
ŋ̊ǃˠˀ	N_0!\_G_?
ŋ̊ǃ̠ʰ	N_0!\_-_h
ŋ̊ǃʰ	N_0!\_h
ŋǃʰ	N!\_h
ŋ̊ǃ̠ˀ	N_0!\_-_?
ŋ̊ǃˀ	N_0!\_?
ŋǃʼ	N!\_>
ŋǃǃ	N!\!\
ŋǃǃʰ	N!\!\_h
ŋ̊ʘ	N_0O\
ŋʘ	NO\
ø	2
ø̠	2_-
ø̈	2_"
ø̰	2_k
ø̞	2_o
ø̤	2_t
ø̆	2_X
ø̃	2~
o	o
ö	o_"
o̯	o_^
o̰	o_k
õ̰	o_k~
o̞	o_o
o̞̊	o_o_0
o̞̥	o_o_0
õ̞	o_o~
o̤	o_t
ŏ	o_X
õ	o~
o˞	o`
ø̞ː	2_o:
øː	2:
ø̃ː	2~:
o̰ː	o_k:
o̞ː	o_o:
õ̞ː	o_o~:
o̤ː	o_t:
oː	o:
õː	o:~
õː	o:~
õː	o~:
øːː	2::
oːː	o::
oːi	o:i
oːj	o:j
oːu	o:u
õːu	o~:u
oːw	o:w
øːy	2:y
o̰ˑ	o_k:\
o̤ˑ	o_t:\
oˑ	o:\
ôː	o:_F
óː	o:_H
òː	o:_L
ô	o_F
ó	o_H
ò	o_L
õ̞ã	o_o~a~
o̞a	o_oa
õã	o~a~
oa	oa
õ̞ãˤ	o_o~a~_?\
o̞aˤ	o_oa_?\
øɑ	2A
oɑ	oA
øe	2e
œ	9
œ̠	9_-
œ̞	9_o
œ̤	9_t
œ̃	9~
o̞e̞	o_oe_o
oe	oe
oe̞	oe_o
œ̠ː	9_-:
œ̰ː	9_k:
œ̞ː	9_o:
œː	9:
œ̃ː	9~:
œ̞ɛ̞	9_oE_o
œ̃ɛ̃	9~E~
œi	9i
œj	9j
œu	9u
œy	9y
œʏ	9Y
øə	2@
oə	o@
oɛ	oE
øɘ	2@\
oɘ	o@\
o̰ʰ	o_k_h
øi	2i
õ̞ĩ	o_o~i~
o̞i	o_oi
o̤i̤	o_ti_t
õi	o~i
oi	oi
oĩ	oi~
õ̞ĩˤ	o_o~i~_?\
o̞iˤ	o_oi_?\
øɪ	2I
oɪ	oI
oʲ	o_j
õʲ	o~_j
õj	o~j
oj	oj
oj̃	oj~
oo	oo
oɔ	oO
øu	2u
õ̞ũ	o_o~u~
o̞u	o_ou
õũ	o~u~
ou	ou
oũ	ou~
oʊ	oU
oʊ̃	oU~
ow	ow
ow̃	ow~
øy	2y
øʏ	2Y
oˀ	o_?
øˤ	2_?\
ø̞ˤ	2_o_?\
oˤ	o_?\
o̞ˤ	o_o_?\
õ̞ˤ	o_o~_?\
õˤ	o~_?\
oˤː	o_?\:
o̞ˤː	o_o_?\:
ɶ	&
ɶː	&:
ɔ	O
ɔ̰	O_k
ɔ̞	O_o
ɔ̞̃	O_o~
ɔ̤	O_t
ɔ̆	O_X
ɔ̃	O~
ɔ˞	O`
ɔ̰ː	O_k:
ɔ̞ː	O_o:
ɔ̞̃ː	O_o~:
ɔ̤ː	O_t:
ɔː	O:
ɔ̃ː	O:~
ɔ̤̃ː	O~_t:
ɔ̃ː	O~:
ɔːi	O:i
ɔ̰ˑ	O_k:\
ɔ̤ˑ	O_t:\
ɔˑ	O:\
ɔa	Oa
ɔaː	Oa:
ɔe	Oe
ɔə	O@
ɔɛ	OE
ɔ̤i̤	O_ti_t
ɔ̃ĩ	O~i~
ɔi	Oi
ɔɪ	OI
ɔɨ	O1
ɔj	Oj
ɔo	Oo
ɔu	Ou
ɔ̃ʊ̃	O~U~
ɔʊ	OU
ɔw	Ow
ɔy	Oy
ɔyː	Oy:
ɔʏ	OY
ɔˤ	O_?\
ɔˤː	O_?\:
ɔ̃ˤː	O~_?\:
ɵ	8
ɵ̞	8_o
ɵ̞̰	8_o_k
ɵ̞̆	8_o_X
ɵ̤	8_t
ɵ̆	8_X
ɵ̃	8~
ɵː	8:
ɵə	8@
ɵy	8y
p̚	p_}
p	p
p͈	p_"\
p͈	p*
p̪	p_d
p̰	p_k
p̃	p~
p˞	p`
pː	p:
pːː	p::
pːʰ	p:_h
pːʼ	p:_>
pf	pf
pfʰ	pf_h
pfʼ	pf_>
pˠ	p_G
pˠʰ	p_G_h
pʰ	p_h
pʰ˞	p_h`
pʰʲ	p_h_j
pʰʷ	p_h_w
pʰˤ	p_h_?\
pʱ	p_h\
pɦ	ph\
pʲ	p_j
pʲ	p'
pʲː	p_j:
pʲʰ	p_j_h
pʲʰ	p'_h
pkʰ	pk_h
pm	pm
pp	pp
pɸ	pp\
pɾ	p4
ps	ps
psʰ	ps_h
psʷ	ps_w
psʷʰ	ps_w_h
pʃʰ	pS_h
pʃʼ	pS_>
pt	pt
pʷ	p_w
pʷˠ	p_w_G
pʷˠː	p_w_G:
pʷˠʰ	p_w_G_h
pʷʼ	p_w_>
pˀ	p_?
pʼ	p_>
pʼː	p_>:
pʼʲ	p_>_j
pʼkxʼ	p_>kx_>
pˤ	p_?\
ɸ	p\
ɸ̞	p\_o
ɸː	p\:
ɸʰ	p\_h
ɸʲ	p\_j
ɸʲ	p\'
ɸʷ	p\_w
ɸʷˠ	p\_w_G
q	q
q̚	q_}
q͈	q_"\
q̺	q_a
q̰	q_k
qː	q:
qːʷ	q:_w
qʰ	q_h
qʰʲ	q_h_j
qʰʷ	q_h_w
qʰʷʲ	q_h_w_j
qʲ	q_j
qʲʼ	q_j_>
qm	qm
qn	qn
q͈ʷ	q_"\_w
q̰ʷ	q_k_w
qʷ	q_w
qʷː	q_w:
qʷʰ	q_w_h
qʷʲ	q_w_j
qʷˀ	q_w_?
qʷʼ	q_w_>
qʷʼʲ	q_w_>_j
qʷˤʰ	q_w_?\_h
qʷˤʼ	q_w_?\_>
qˀ	q_?
qʼ	q_>
qʼː	q_>:
qʼːʷ	q_>:_w
qʼʲ	q_>_j
qˤ	q_?\
qˤʰ	q_?\_h
qˤʼ	q_?\_>
qǀ	q|\
qǀʰ	q|\_h
qǀʼ	q|\_>
qǁ	q|\|\
qǁʰ	q|\|\_h
qǁʼ	q|\|\_>
qǂ	q=\
qǂʰ	q=\_h
qǂʼ	q=\_>
qǃ	q!\
qǃʰ	q!\_h
qǃʼ	q!\_>
qʘ	qO\
qʘʰ	qO\_h
qʘʼ	qO\_>
qχ	qX
qχː	qX:
qχːʰ	qX:_h
qχːʼ	qX:_>
qχʰ	qX_h
qχʷ	qX_w
qχʷʼ	qX_w_>
qχʷˤ	qX_w_?\
qχʷˤʼ	qX_w_?\_>
qχʼ	qX_>
qχʼː	qX_>:
qχˤ	qX_?\
qχˤː	qX_?\:
qχˤʼ	qX_?\_>
r	r
r̠	r_-
r̩	r=
r̊	r_0
r̥	r_0
r̺	r_a
r̺̊	r_a_0
r̺̥	r_a_0
r̪	r_d
r̪̊	r_d_0
r̪̥	r_d_0
r̪̰	r_d_k
r̰	r_k
r̝	r_r
r̤	r_t
r̃	r~
r͈ː	r_"\:
r̩ː	r=:
r̊ː	r_0:
r̥ː	r_0:
r̪ː	r_d:
rː	r:
rːː	r::
r̪ˠ	r_d_G
rʰ	r_h
rʱ	r_h\
r̠ʲ	r_-_j
r̊ʲ	r_0_j
r̥ʲ	r_0_j
r̺ʲ	r_a_j
r̪ʲ	r_d_j
rʲ	r_j
rʲ	r'
r̊ʲː	r_0_j:
r̥ʲː	r_0_j:
rʲː	r_j:
rr	rr
rᶣ	r_H
rʷ	r_w
rˀ	r_?
rʼ	r_>
rʼː	r_>:
rˤ	r_?\
rˤː	r_?\:
ʀ	R\
ɹ	r\
ɹ̊	r\_0
ɹ̥	r\_0
ɹ̺	r\_a
ɹ̪	r\_d
ɹ̪̊	r\_d_0
ɹˤ	r\_?\
ɹ̰ˤ	r\_k_?\
ɺ	l\
ɺ̠	l\_-
ɺ̊	l\_0
ɺ̥	l\_0
ɺ̪	l\_d
ɺː	l\:
ɻ	r\`
ɻ̊	r\`_0
ɻː	r\`:
ɻʲ	r\`_j
ɻʷ	r\`_w
ɻˤ	r\`_?\
ɽ	r`
ɽ̩	r`=
ɽ̊	r`_0
ɽ̤	r`_t
ɽ̃	r`~
ɽʰ	r`_h
ɽʱ	r`_h\
ɽ̤ʱ	r`_t_h\
ɾ	4
ɾ̠	4_-
ɾ̊	4_0
ɾ̥	4_0
ɾ̺	4_a
ɾ̪	4_d
ɾ̪̊	4_d_0
ɾ̪̰	4_d_k
ɾ̤	4_t
ɾ̃	4~
ɾː	4:
ɾ̊ˠ	4_0_G
ɾ̥ˠ	4_0_G
ɾ̪ˠ	4_d_G
ɾˠ	4_G
ɾ̪̊ʰ	4_d_0_h
ɾʰ	4_h
ɾ̊ʲ	4_0_j
ɾ̥ʲ	4_0_j
ɾ̪ʲ	4_d_j
ɾʲ	4_j
ɾʲ	4'
ɾʲʷ	4_j_w
ɾʷ	4_w
ɾˀ	4_?
ɾˤ	4_?\
ʁ	R
ʁ̞	R_o
ʁː	R:
ʁʲ	R_j
ʁ̞̰ʷ	R_o_k_w
ʁ̞ʷ	R_o_w
ʁʷ	R_w
ʁʷˤ	R_w_?\
ʁˤ	R_?\
s	s
s̠	s_-
s͈	s_"\
s͈	s*
s̩	s=
s̺	s_a
s̪	s_d
s̰	s_k
s͈ː	s_"\:
s̺ː	s_a:
s̪ː	s_d:
sː	s:
sːː	s::
sˠ	s_G
s̪ʰ	s_d_h
sʰ	s_h
s̪ʲ	s_d_j
sʲ	s_j
sʲ	s'
sʲː	s_j:
sʲːː	s_j::
sʲʰ	s_j_h
sʲʷ	s_j_w
sɾ	s4
ss	ss
st	st
sᶣ	s_H
s̪ʷ	s_d_w
sʷ	s_w
s̪ʷː	s_d_w:
s̪ʷʲ	s_d_w_j
sˀ	s_?
s̪ˀ	s_d_?
sʼ	s_>
s̪ʼ	s_d_>
sʼː	s_>:
sˤ	s_?\
s̪ˤ	s_d_?\
sˤː	s_?\:
ʂ	s`
ʂː	s`:
ʂʰ	s`_h
ʂʲ	s`_j
ʂʷ	s`_w
ʂʼ	s`_>
ʃ	S
ʃ͈	S_"\
ʃ̺	S_a
ʃ̞	S_o
ʃ͈ː	S_"\:
ʃː	S:
ʃːː	S::
ʃːʷ	S:_w
ʃˠ	S_G
ʃʰ	S_h
ʃʲ	S_j
ʃʲ	S'
ʃʃ	SS
ʃt	St
ʃ͈ʷ	S_"\_w
ʃʷ	S_w
ʃʷː	S_w:
ʃˀ	S_?
ʃʼ	S_>
ʃ̞ʼ	S_o_>
ʅ	ʅ
t̚	t_}
t	t
t̻ʲ	t'
t̠	t_-
t͈	t_"\
t͈	t*
t̺	t_a
t̺̪	t_a_d
t̪	t_d
t̪̺	t_d_a
t̪̰	t_d_k
t̰	t_k
t̃	t~
t͈ː	t_"\:
t̺ː	t_a:
t̪ː	t_d:
t̪ː	t:_d
tː	t:
tːː	t::
tːs	t:s
tːʃ	t:S
tːʃʼ	t:S_>
tːʼ	t:_>
t̪ʙ	t_dB\
tç	tC
tçʰ	tC_h
t̺ɕ̺	t_as\_a
ʨ	ts\
ʨː	ts\:
ʨʰ	ts\_h
ʨᶣ	ts\_H
ʨʷ	ts\_w
tɕʷʰ	ts\_w_h
ʨʷʰ	ts\_w_h
tɕʷʼ	ts\_w_>
ʨʷʼ	ts\_w_>
t̺ɕ̺ʼ	t_as\_a_>
tɕʼ	ts\_>
ʨʼ	ts\_>
t̪ˠ	t_d_G
tˠ	t_G
t̪ˠʰ	t_d_G_h
t̠ʰ	t_-_h
t̺ʰ	t_a_h
t̪ʰ	t_d_h
tʰ	t_h
t̪ʰː	t_d_h:
t̪ʰʲ	t_d_h_j
tʰʲ	t_h_j
t̪ʰʷ	t_d_h_w
tʰʷ	t_h_w
t̪ʰʷʲ	t_d_h_w_j
tʰʼ	t_h_>
t̪ʰˤ	t_d_h_?\
t̪ɦ	t_dh\
tʱ	t_h\
t̠ʲ	t_-_j
t̪ʲ	t_d_j
tʲ	t_j
tʲ	t'
tʲː	t_j:
tʲːː	t_j::
t̪ʲʰ	t_d_j_h
tʲʰ	t_j_h
tʲʰ	t'_h
tʲʷ	t_j_w
tʲʷ	t'_w
tʲʼ	t_j_>
tʲʼ	t'_>
tl	tl
tlʰ	tl_h
t̪ɬ	t_dK
t̪ɬ̪	t_dK_d
tɬ	tK
tɬ̰	tK_k
t̪ɬ̪ː	t_dK_d:
tɬː	tK:
tɬːʰ	tK:_h
tɬːʼ	tK:_>
t̪ɬ̪ʰ	t_dK_d_h
tɬʰ	tK_h
tɬʰʷ	tK_h_w
t̪ɬ̪ʷʰ	t_dK_d_w_h
t̪ɬ̪ʷʼ	t_dK_d_w_>
tɬʷʼ	tK_w_>
t̪ɬ̪ˀ	t_dK_d_?
t̪ɬʼ	t_dK_>
t̪ɬ̪ʼ	t_dK_d_>
tɬʼ	tK_>
t̪ɬ̪ʼː	t_dK_d_>:
tɬʼː	tK_>:
t̠n̠	t_-n_-
t̪n̪	t_dn_d
tn	tn
tr	tr
tɾ	t4
t͈s	t_"\s
t͈ɕ	ts\*
t̺s̺	t_as_a
t̪s	t_ds
t̪s̪	t_ds_d
t̰s̰	t_ks_k
tˢ	t_s
ʦ	ts
ts	ts
t͡s	ts
ʦ̺	ts_a
ʦ̪	ts_d
ʦ̰	ts_k
t̺s̺ː	t_as_a:
t̪s̪ː	t_ds_d:
ʦː	ts:
ʦːʰ	ts:_h
ʦːʼ	ts:_>
ʦˠ	ts_G
t̪s̪ʰ	t_ds_d_h
ʦʰ	ts_h
t̪s̪ʰʲ	t_ds_d_h_j
t̪s̪ʰʷ	t_ds_d_h_w
ʦʰʷ	ʦ_h_w
t̪s̪ʰʷʲ	t_ds_d_h_w_j
ʦʰˤ	ts_h_?\
t̪s̪ɦ	t_ds_dh\
ʦʱ	ts_h\
t̪ˢʲ	t_d_s_j
t̪s̪ʲ	t_ds_d_j
ʦʲ	ts_j
ʦʲ	ts'
ʦʲː	ts_j:
ʦʲʰ	ʦ_j_h
t͈sʷ	t_"\s_w
t̪s̪ʷ	t_ds_d_w
ʦʷ	ts_w
t̪s̪ʷː	t_ds_d_w:
t̪s̪ʷʰ	t_ds_d_w_h
ʦʷʰ	ts_w_h
t̪s̪ʷʲ	t_ds_d_w_j
t̪s̪ʷʼ	t_ds_d_w_>
ʦʷʼ	ts_w_>
t̪s̪ʷʼʲ	t_ds_d_w_>_j
ʦˀ	ʦ_?
t̪s̪ʼ	t_ds_d_>
ʦʼ	ts_>
t̪s̪ʼː	t_ds_d_>:
ʦʼː	ts_>:
t̪s̪ʼʲ	t_ds_d_>_j
tʂ	ts`
tʂʰ	ts`_h
t̠ʃ	t_-S
t̠ʃ͉	t_-S͉
t̠ʃ̰	t_-S_k
t̺ʃ̺	t_aS_a
t̪ʃ	t_dS
ʧ	tS
tʃ	tS
t͡ʃ	tS
t͈ʃ	tS_"\
ʧ̺	tS_a
t̠ʃː	t_-S:
ʧː	tS:
ʧːʰ	tS:_h
ʧːʷ	tS:_w
ʧːʼ	tS:_>
t̠ʃˠ	t_-S_G
t̠ʃ̺ʰ	t_-S_a_h
t̠ʃʰ	t_-S_h
ʧ̺ʰ	tS_a_h
ʧʰ	tS_h
tʃʰ	tS_h
t̠ʃʰː	t_-S_h:
ʧʰʷ	tS_h_w
ʧʰˤ	tS_h_?\
t̠ʃʱ	t_-S_h\
ʧʱ	tS_h\
t̠ʃʲ	t_-S_j
ʧʲ	tS_j
ʧʲ	tS'
ʧʲʰ	tS_j_h
t̠ʃɾ	t_-S4
t̠ʃʷ	t_-S_w
t̺ʃ̺ʷ	t_aS_a_w
t͈ʃʷ	tS_"\_w
ʧʷ	tS_w
t̠ʃʷː	t_-S_w:
ʧʷː	tS_w:
t̠ʃʷʰ	t_-S_w_h
ʧʷʰ	tS_w_h
t̠ʃʷʼ	t_-S_w_>
ʧʷʼ	tS_w_>
t̠ʃx	t_-Sx
t̠ʃˀ	t_-S_?
ʧˀ	tS_?
t̠ʃʼ	t_-S_>
ʧʼ	tS_>
t̠ʃʼː	t_-S_>:
ʧʼː	tS_>:
ʧʼˤ	tS_>_?\
ʧˤ	tS_?\
tt	tt
tts	tts
ttʃ	ttS
t̪ʷ	t_d_w
tʷ	t_w
t̪ʷʰ	t_d_w_h
tʷʰ	t_w_h
t̪ʷʲ	t_d_w_j
t̪ʷʼ	t_d_w_>
tʷʼ	t_w_>
t̪ʷʼʲ	t_d_w_>_j
t̪x	t_dx
tx	tx
tz̤̥	tz_t_0
tˀ	t_?
t̪ˀ	t_d_?
tʼ	t_>
t̺ʼ	t_a_>
t̪ʼ	t_d_>
tʼː	t_>:
t̪ʼː	t_d_>:
t̪ʼʲ	t_d_>_j
tʼkxʼ	t_>kx_>
t̪ʼkxʼ	t_d_>kx_>
t̪ʼˤ	t_d_>_?\
tˤ	t_?\
t̪ˤ	t_d_?\
tˤː	t_?\:
t̪θ	t_dT
t̪θʰ	t_dT_h
t̪θʼ	t_dT_>
ʈ	t`
ʈː	t`:
ʈʰ	t`_h
ʈʲ	t`_j
ʈɳ	t`n`
ʈr	t`r
ʈr̥	t`r_0
ʈɹ̠̊	t`r\_-_0
ʈɹ̠̥	t`r\_-_0
ʈɹ̥	t`r\_0
ʈɽ	t`r`
ʈɽʰ	t`r`_h
ʈʂ	t`s`
ʈʂʰ	t`s`_h
ʈʂʷ	t`s`_w
ʈʂʼ	t`s`_>
ʈʼ	t`_>
u	u
ü	u_"
u̯	u_^
ů	u_0
u̥	u_0
ṵ	u_k
ṵ̃	u_k~
u̞	u_o
ṳ	u_t
ŭ	u_X
u͓	u_x
ũ	u~
u˞	u`
u˞ˤ	u`_?\
u˞ˤː	u`_?\:
üː	u_":
ṵː	u_k:
u̞ː	u_o:
ṳː	u_t:
uː	u:
u̟ː	u:_+
uː̃	u:~
ṳ̃ː	u~_t:
ũː	u~:
ũː	u:~
ũː	u:~
uːː	u::
uːa	u:a
uːe	u:e
uːə	u:@
uːi	u:i
uːj	u:j
uːʌ	u:V
ṳˑ	u_t:\
uˑ	u:\
ûː	u:_F
úː	u:_H
ùː	u:_L
û	u_F
ú	u_H
ù	u_L
ṳa	u_ta
ṳa̤	u_ta_t
ũã	u~a~
ua	ua
uã	ua~
uaː	ua:
uãː	ua~:
uæ	u{
uai	uai
ṳɐ	u_t6
uɐ	u6
uɑ	uA
uɑ̃	uA~
uɑ˞	uA`
uɑi	uAi
ue	ue
ue̞	ue_o
uẽ	ue~
uei	uei
ṳə̤	u_t@_t
uə	u@
ũə	u~@
uəi	u@i
uɛ	uE
uɛ̃	uE~
uɜ	u3
uʰ	u_h
ṵʰ	u_k_h
ṳi̤	u_ti_t
ũi	u~i
ũĩ	u~i~
ui	ui
uɪ	uI
uj	uj
ũo	u~o
uo	uo
uo̞	uo_o
uõ	uo~
ũoː	u~o:
uoː	uo:
uœ	u9
uɔ	uO
u̠u	u_-u
uʌ	uV
uw	uw
uy	uy
uˀ	u_?
uˤ	u_?\
ũˤ	u~_?\
uˤː	u_?\:
ʉ	}
ʉ̰	}_k
ʉ̞	}_o
ʉ̆	}_X
ʉ̃	}~
ʉː	}:
ʉ̃ː	}~:
ʉɞ̠	}3\_-
ʉi	}i
ʉœ̠	}9_-
ʉu	}u
ɥ	H
ɥ̊	H_0
ɥ̥	H_0
ɥ̃	H~
ɥˤ	H_?\
ɯ	M
ɯ̰	M_k
ɯ̞	M_o
ɯ̞̆	M_o_X
ɯ̤	M_t
ɯ̽	M_x
ɯ͓	M_x
ɯ̃	M~
ɯ̤ː	M_t:
ɯ̰̽ː	M_x_k:
ɯ̽ː	M_x:
ɯː	M:
ɯ̃ː	M~:
ɯːə	M:@
ɯːi	M:i
ɯ̤a	M_ta
ɯa	Ma
ɯɑ	MA
ɯ̤ə̤	M_t@_t
ɯə	M@
ɯ̃ə	M~@
ɯˠ	M_G
ɯ̤i̤	M_ti_t
ɯi	Mi
ɯɪ	MI
ɯj	Mj
ɯo	Mo
ɯu	Mu
ɯʌ	MV
ɰ	M\
ɰ̰	M\_k
ɰ̃	M\~
ʊ	U
ʊ̰	U_k
ʊ̞	U_o
ʊ̤	U_t
ʊ̆	U_X
ʊ̽	U_x
ʊ̈	U\
ʊ̃	U~
ʊ̤ː	U_t:
ʊː	U:
ʊ̈ː	U\:
ʊ̃ː	U~:
ʊa	Ua
ʊe	Ue
ʊə	U@
ʊi	Ui
ʊ̈i	Üi
ʊɪ	UI
ʊɨ	U1
ʊj	Uj
ʊɔ	UO
ʊu	Uu
ʊˤ	U_?\
ʊˤː	U_?\:
v	v
v̩	v=
v̊	v_0
v̥	v_0
v̤	v_t
ṽ	v~
vː	v:
vˠ	v_G
vʰ	v_h
vʲ	v_j
vʲ	v'
vɾ	v4
vv	vv
vʷ	v_w
vˤ	v_?\
ʋ	v\
ʋ̩	v\=
ʋʲ	v\_j
ⱱ	v_4
ʌ	V
ʌ̤	V_t
ʌ̃	V~
ʌ̤ː	V_t:
ʌː	V:
ʌ̃ː	V~:
ʌə	V@
ʌi	Vi
ʌĩ	Vi~
ʌj	Vj
ʌj̃	Vj~
ʌu	Vu
ʌũ	Vu~
ʌʊ	VU
ʌw	Vw
ʌw̃	Vw~
ʌˤː	V_?\:
w	w
ẘ	w_0
w̥	w_0
w̰	w_k
w̞	w_o
w̤	w_t
w̃	w~
wː	w:
wa	wa
wã	wa~
waː	wa:
wæi	w{i
wai	wai
ʷd	_wd
we	we
wei	wei
weu	weu
wə	w@
wə̃	w@~
wɛ	wE
wɛ̃	wE~
wɛi	wEi
wʰ	w_h
wʱ	w_h\
wi	wi
wʲ	w_j
wʲ	w'
ʷɟ	_wJ\
ʷl	_wl
ʷm	_wm
wo	wo
wõ	wo~
woː	wo:
wõː	wo~:
wɔ	wO
wɔ̃	wO~
wɔː	wO:
ʷr	_wr
ww	ww
ʷz	_wz
ʷʐ	_wz`
ʷʑ	_wz\
wˀ	w_?
wʼ	w_>
wˤ	w_?\
ʍ	W
ʍʲ	W_j
x	x
x̠	x_-
x͈	x_"\
x͈ː	x_"\:
xː	x:
xːʷ	x:_w
xʰ	x_h
xʲ	x_j
xʲ	x'
xʲː	x_j:
xk	xk
x͈ʷ	x_"\_w
xʷ	x_w
xʷː	x_w:
xʷʼ	x_w_>
xʼ	x_>
y	y
y̰	y_k
y̞	y_o
y̤	y_t
ỹ	y~
y̰ː	y_k:
yː	y:
ỹː	y~:
yːː	y::
ya	ya
yæ	y{
yɑ	yA
ye	ye
yə	y@
yɛ	yE
yɜ	y3
yi	yi
yĩ	yi~
yø	y2
yø̞	y2_o
yo	yo
ỹœ	y~9
yœ	y9
ỹœː	y~9:
yœː	y9:
yu	yu
yʼ	y_>
ʏ	Y
ʏ̃	Y~
ʏː	Y:
ʏ̃ː	Y~:
z	z
z̠	z_-
z̩	z=
z̊	z_0
z̥	z_0
z̺	z_a
z̪	z_d
z̤	z_t
z̃	z~
z͈ː	z_"\:
z̪ː	z_d:
zː	z:
zˠ	z_G
zʰ	z_h
z̪ʲ	z_d_j
zʲ	z_j
zʲ	z'
zʲː	z_j:
zɾ	z4
z̪ʷ	z_d_w
zʷ	z_w
zz	zz
zˀ	z_?
zˤ	z_?\
z̪ˤ	z_d_?\
zˤː	z_?\:
ʐ	z`
ʐ̩	z`=
ʐʲ	z`_j
ʐʷ	z`_w
ʑ	z\
ʑʰ	z\_h
ʑᶣ	z\_H
ʑʷ	z\_w
ʒ	Z
ʒ̩	Z=
ʒ̊	Z_0
ʒ̺	Z_a
ʒ̤	Z_t
ʒ͈ː	Z_"\:
ʒː	Z:
ʒˠ	Z_G
ʒʲ	Z_j
ʒʲ	Z'
ʒʷ	Z_w
ʒʒ	ZZ
ʒˀ	Z_?
ʒˤ	Z_?\
ʔ	?
ʔ̬	?_v
ʔ̃	?~
ʔː	?:
ʔʲ	?_j
ʔʲ	?'
ʔɾ	?4
ʔʷ	?_w
ʔw	?w
ʔʷʼ	?_w_>
ʔʔ	??
ʔʼ	?_>
ʔˤ	?_?\
ˀb	_?b
ˀb͉	_?b_}
ˀc	_?c
ˀd	_?d
ˀd̪	_?d_d
ˀʤ	_?dZ
ˀɖ	_?d`
ˀɡ	_?g
ˀɡb	_?gb
ˀɡʷ	_?g_w
ˀj	_?j
ˀj̊	_?j_0
ˀj̰	_?j_k
ˀk	_?k
ˀkp	_?kp
ˀkʷ	_?k_w
ˀl	_?l
ˀl̪̊	_?l_d_0
ˀm	_?m
ˀm̊	_?m_0
ˀn	_?n
ˀn̪̊	_?n_d_0
ˀnǀ	_?n|\
ˀnǁ	_?n|\|\
ˀnǂ	_?n=\
ˀnǃ	_?n!\
ˀnʘ	_?nO\
ˀɲ	_?J
ˀŋ	_?N
ˀo	_?o
ˀp	_?p
ˀq	_?q
ˀr	_?r
ˀs	_?s
ˀʃʷ	_?S_w
ˀt	_?t
ˀt̪	_?t_d
ˀt̪ɬ	_?t_dK
ˀt̪s	_?t_ds
ˀw	_?w
ˀẘ	_?w_0
ˀw̰	_?w_k
ˀʍ	_?W
ˀʍʲ	_?W_j
ˀy	_?y
ʼb	_>b
ʼd	_>d
ʼɡ	_>ɡ
ʼɣ	_>G
ʼj	_>j
ʼl	_>l
ʼm	_>m
ʼn	_>n
ʼɲ	_>J
ʼŋ	_>N
ʼŋǀ	_>N|\
ʼŋǃ	_>N!\
ʼs	_>s
ʼʃ	_>S
ʼw	_>w
ʕ	?\
ʕ̰	?\_k
ʕː	?:
ʕ̰ʷ	?\_k_w
ʕʷ	?\_w
ʕʷʼ	?\_w_>
ʕʼ	?\_>
ʡ	>\
ʡʼ	>\_>
ʡˤ	>\_?\
ʢ	<\
ʢʷ	<\_w
ǀ	|\
ǁ	|\|\
ǂ	=\
ǂ̬	=\_v
ǂ̃	=\~
ǂʰ	=\_h
ǂ̃ʰ	=\~_h
ǃ	!\
ǃ̬	!\_v
ǃ̃	!\~
ǃʰ	!\_h
ǃ̃ʰ	!\~_h
ʘ	O\
ʘ̬	O\_v
ʘ̃	O\~
ʘʰ	O\_h
ʘ̃ʰ	O\~_h
β	B
β̩	B=
β̞	B_o
β̃	B~
βː	B:
β̞ˠ	B_o_G
βʲ	B_j
βʲ	B'
β̞ʲ	B_o_j
βʲː	B_j:
βʲː	B':
βʷ	B_w
θ	T
θ̪	T_d
θ̰	T_k
θʼ	T_>
χ	X
χ͈	X_"\
χː	X:
χːʷ	X:_w
χʲ	X_j
χ͈ʷ	X_"\_w
χʷ	X_w
χʷː	X_w:
χʷʲ	X_w_j
χʷʼ	X_w_>
χʷˤ	X_w_?\
χʷˤː	X_w_?\:
χʼ	X_>
χˤ	X_?\
χˤː	X_?\:
χˤʷ	X_?\_w
